11111111111111111111111111111111
10000000000000000000000000000001
10000000000000000000000000000001
100001111111111111110000000E0001
100001CCCCCCCCCCCCC10000000P0001
100001CCCCCCCCCCCCC1000000000001
100001CCCCCCCCCCCCC0000000000001
10000111111111111111000000000001
11111111111111111111111111111111
