11111111111111111111111111111111
10000000000000000000000000000001
10000000000000000000000000011111
1000011111111111111100000001E001
100001CCCCCCCCCCCCC1000000011111
100001CCCCCCCCCCCCC100P000000001
100001CCCCCCCCCCCCC0000000000001
10000111111111111111000000000001
11111111111111111111111111111111
