1111111111111
1E0100C00CC01
100P011111111
1000110001001
1111111111111
