111111111111111111111111111111
111111111111111111111111111111
1PC000C0000CC000C00C00C000CC01
1000C000000C000000C00000000001
10000C00000C000CC000C0C0C00001
1C000000C000C00000C000C0000C01
1000000C000CCC000000000C000001
10000C000C00C00CC0C000CC00C0C1
1CC000C00C00000000C0000CC00001
10CC000000000C00C000C0C00000C1
1000000000000000000C0000CC0CC1
100C00000C00000000C000C00000C1
1C000CC00C000CC000000000000001
10000CC0C0C0C0C0000000C0000001