11111111111111111111111111111111111111111111111111
11111111111111111111111111111111111111111111111111
1P0000C0000000000000000000000C000000C0C000CCCC0C01
1CC0000000C0C00C00C00000000C0000000CC00000C000C001
100000000000000C0CC0000C0000C0CC00000C0C0C00000001
1C000C0C0000C0C0C000000C00CC0000C000000C000000C001
1000C000000000000CC000C000000CC0000C000000000C0001
10000C0C00000000CC00000000C00000C000C000000CC00C01
1CC0000000C000CC0000C0000C0000CC00C0000CC00000C0C1
1000C0C000000C000000000000C0000000000C0CC0000000C1
1C000000C00C0C000C000000C0C0000C00C0CC000000C00001
100C000000C0000C0000C000C000CC0000000000C0000CC001
10C000C0C0C0C00C000000CC00C000000000000C0C00000001
1000000000C0000000C00000000C00C00000000CC0CCC000C1
1C00000C0000CC0C000C0C0C0000C000000C0000C00C000C01
1C0C00C0CC000000CC0C00000000C00000CC0C0C00CC000001
10CC00C000000000CC00C0C0000C0C000000000C000C000001
10CC0000C0CC000C0C0000000000000000C000C00000000001
10C0000C00C00C000000C00C000C0000000000000000000C01