11111111111111111111
11111111111111111111
1P0000000C0000C00001
10000C00000C000000C1
1000C0000000000C0001
1C00C0C0000000000C01
1C0000000000000000C1
1C0CC0000C000C000001
1C0C00000000000C0001

