11111
1P0C1
00001
1C0E1
11110
