11111
1P0X1
1Z0E1
1C001
11111
