111111
1P0C01
111101
1C0001
1E1111
111111
