111111
1P0C01
111101
110001
1E1111
111111