11111
1P1C1
11111
1C1E1
11111
