111111
1P0C1
1001
1C0E1
11111
