111111
1P0001
100001
111101
1C00E1
111111