1111111111111111111
1000000000000000001
10P0000000000000001
1000111111111100001
10001CCCCCCCC100E01
10001CCCCCCCC000001
1000111111111100001
1111111111111111111
