1111111
1P000C1
1C11001
1000001
1C01E01
1111111
