1111111
1P000C1
1C010C1
1C000C1
1C01E01
1111111